NO xpm/t2.xpm
SO xpm/t2.xpm
EA xpm/t2.xpm
WE xpm/t2.xpm 

F 144,238,144
C 137,207,240


               1111111111111111111111111
               1000000000000000000000001
               1000000000000000000000001
               1000000000000000000000001
1111111111111111000000001111111111111111
1000000100000000100000001
1000000100000000100000001
1000000100000000000000001
10000001S0000000100000001
1000100100000000100000001
1001010100000000100000001
1000000111111111100000001
1000000000000000000000001
1000000000000000000000001
1000000000000000000000001
1000000000000000000000001
1000000000000000000000001
1000000000000000000000001
1111111111111111111111111

