NO xpm/t4.xpm
SO xpm/t4.xpm
EA xpm/t4.xpm
WE xpm/t4.xpm

F 144,20,250
C 137,207,240

               1111111111111111111111111
               1000000000000000000000001
               1000000000000000000000001
               1000000000000000000000001
1111111111111111000000001111111111111111
1000000100000000100000001
1000000100000000100000001
1000000100000000000000001
1000000100000000100000001
10000001000N0000100000001
1000000100000000100000001
1000000111111111100000001
1000000000000000000000001
1000000000000000000000001
1000000000000000000000001
1000000000000000000000001
1000000000000000000000001
1000000000000000000000001
1111111111111111111111111
